1860 München,Preußen Münster,2019-07-19,1,1,2,y,0,1,1,0,1,1,0,0,1,1,4,2,6,5,1,1,5,6,3. Liga - Germany,3053138
Würzburger Kickers,Bayern München II,2019-07-20,3,1,4,y,1,0,0,1,1,2,1,1,2,3,3,2,5,5,4,4,5,9,3. Liga - Germany,3053139
Kaiserslautern,Unterhaching,2019-07-20,1,1,2,y,1,0,0,1,1,0,1,1,0,1,3,3,6,4,1,1,4,5,3. Liga - Germany,3053140
MSV Duisburg,Sonnenhof Großaspach,2019-07-20,4,1,5,y,1,1,1,1,2,3,0,0,3,3,0,0,0,3,5,5,3,8,3. Liga - Germany,3053141
Meppen,Zwickau,2019-07-20,0,2,2,n,0,0,0,0,0,0,2,2,0,2,2,4,6,10,6,6,10,16,3. Liga - Germany,3053142
Hansa Rostock,Viktoria Köln,2019-07-20,3,3,6,y,3,1,1,3,4,0,2,2,0,2,1,0,1,2,5,5,2,7,3. Liga - Germany,3053143
Magdeburg,Eintracht Braunschweig,2019-07-20,2,4,6,y,1,3,3,1,4,1,1,1,1,2,3,3,6,5,5,5,5,10,3. Liga - Germany,3053144
Chemnitzer FC,Waldhof Mannheim,2019-07-21,1,1,2,y,0,1,1,0,1,1,0,0,1,1,0,2,2,9,3,3,9,12,3. Liga - Germany,3053145
Uerdingen,Hallescher FC,2019-07-21,1,0,1,n,0,0,0,0,0,1,0,0,1,1,4,4,8,1,15,15,1,16,3. Liga - Germany,3053146
Carl Zeiss Jena,Ingolstadt,2019-07-22,1,2,3,y,0,0,0,0,0,1,2,2,1,3,2,2,4,3,5,5,3,8,3. Liga - Germany,3053147
Zwickau,Magdeburg,2019-07-28,0,0,0,n,0,0,0,0,0,0,0,0,0,0,2,1,3,5,4,4,5,9,3. Liga - Germany,3053148
Eintracht Braunschweig,1860 München,2019-07-27,2,1,3,y,1,1,1,1,2,1,0,0,1,1,4,7,11,3,5,5,3,8,3. Liga - Germany,3053149
Preußen Münster,Carl Zeiss Jena,2019-07-27,2,0,2,n,0,0,0,0,0,2,0,0,2,2,2,2,4,8,7,7,8,15,3. Liga - Germany,3053150
Ingolstadt,MSV Duisburg,2019-07-27,3,2,5,y,1,0,0,1,1,2,2,2,2,4,2,2,4,2,6,6,2,8,3. Liga - Germany,3053151
Sonnenhof Großaspach,Kaiserslautern,2019-07-27,1,3,4,y,0,2,2,0,2,1,1,1,1,2,5,4,9,1,4,4,1,5,3. Liga - Germany,3053152
Unterhaching,Würzburger Kickers,2019-07-27,5,4,9,y,2,3,3,2,5,3,1,1,3,4,5,2,7,5,1,1,5,6,3. Liga - Germany,3053153
Bayern München II,Uerdingen,2019-07-26,2,1,3,y,1,1,1,1,2,1,0,0,1,1,1,5,6,13,2,2,13,15,3. Liga - Germany,3053154
Hallescher FC,Hansa Rostock,2019-07-27,1,0,1,n,0,0,0,0,0,1,0,0,1,1,2,2,4,5,5,5,5,10,3. Liga - Germany,3053155
Viktoria Köln,Chemnitzer FC,2019-07-28,3,2,5,y,2,0,0,2,2,1,2,2,1,3,2,4,6,4,5,5,4,9,3. Liga - Germany,3053156
Waldhof Mannheim,Meppen,2019-07-27,0,0,0,n,0,0,0,0,0,0,0,0,0,0,1,1,2,3,6,6,3,9,3. Liga - Germany,3053157
Chemnitzer FC,Meppen,2019-07-31,2,4,6,y,1,0,0,1,1,1,4,4,1,5,4,1,5,6,10,10,6,16,3. Liga - Germany,3053158
Uerdingen,Unterhaching,2019-07-30,2,2,4,y,2,2,2,2,4,0,0,0,0,0,6,3,9,6,1,1,6,7,3. Liga - Germany,3053159
Würzburger Kickers,Sonnenhof Großaspach,2019-07-30,0,3,3,n,0,1,1,0,1,0,2,2,0,2,5,1,6,10,5,5,10,15,3. Liga - Germany,3053160
Kaiserslautern,Ingolstadt,2019-07-30,0,0,0,n,0,0,0,0,0,0,0,0,0,0,3,2,5,6,1,1,6,7,3. Liga - Germany,3053161
MSV Duisburg,Preußen Münster,2019-07-31,2,0,2,n,0,0,0,0,0,2,0,0,2,2,1,0,1,8,5,5,8,13,3. Liga - Germany,3053162
Carl Zeiss Jena,Eintracht Braunschweig,2019-07-30,0,2,2,n,0,1,1,0,1,0,1,1,0,1,0,1,1,4,9,9,4,13,3. Liga - Germany,3053163
1860 München,Zwickau,2019-07-31,3,0,3,n,1,0,0,1,1,2,0,0,2,2,1,2,3,6,8,8,6,14,3. Liga - Germany,3053164
Magdeburg,Waldhof Mannheim,2019-07-31,1,1,2,y,1,1,1,1,2,0,0,0,0,0,0,2,2,12,2,2,12,14,3. Liga - Germany,3053165
Viktoria Köln,Hallescher FC,2019-07-31,0,2,2,n,0,0,0,0,0,0,2,2,0,2,0,1,1,7,8,8,7,15,3. Liga - Germany,3053166
Hansa Rostock,Bayern München II,2019-07-30,2,1,3,y,1,0,0,1,1,1,1,1,1,2,2,4,6,5,4,4,5,9,3. Liga - Germany,3053167
Zwickau,Carl Zeiss Jena,2019-08-04,2,0,2,n,1,0,0,1,1,1,0,0,1,1,4,6,10,-1,-1,-1,-1,-1,3. Liga - Germany,3053168
Eintracht Braunschweig,MSV Duisburg,2019-08-04,0,3,3,n,0,1,1,0,1,0,2,2,0,2,1,3,4,9,6,6,9,15,3. Liga - Germany,3053169
Preußen Münster,Kaiserslautern,2019-08-03,3,2,5,y,0,1,1,0,1,3,1,1,3,4,4,2,6,7,8,8,7,15,3. Liga - Germany,3053170
Ingolstadt,Würzburger Kickers,2019-08-02,3,0,3,n,0,0,0,0,0,3,0,0,3,3,2,4,6,3,3,3,3,6,3. Liga - Germany,3053171
Sonnenhof Großaspach,Uerdingen,2019-08-03,2,2,4,y,1,1,1,1,2,1,1,1,1,2,0,2,2,7,5,5,7,12,3. Liga - Germany,3053172
Unterhaching,Hansa Rostock,2019-08-03,1,0,1,n,1,0,0,1,1,0,0,0,0,0,3,3,6,2,7,7,2,9,3. Liga - Germany,3053173
Bayern München II,Viktoria Köln,2019-08-03,2,5,7,y,0,3,3,0,3,2,2,2,2,4,4,3,7,8,2,2,8,10,3. Liga - Germany,3053174
Hallescher FC,Chemnitzer FC,2019-08-03,3,1,4,y,1,0,0,1,1,2,1,1,2,3,1,3,4,-1,-1,-1,-1,-1,3. Liga - Germany,3053175
Meppen,Magdeburg,2019-08-03,1,3,4,y,1,0,0,1,1,0,3,3,0,3,1,3,4,4,6,6,4,10,3. Liga - Germany,3053176
Waldhof Mannheim,1860 München,2019-08-05,4,0,4,n,1,0,0,1,1,3,0,0,3,3,2,3,5,3,3,3,3,6,3. Liga - Germany,3053177
Chemnitzer FC,Magdeburg,2019-08-16,0,0,0,n,0,0,0,0,0,0,0,0,0,0,0,5,5,3,3,3,3,6,3. Liga - Germany,3053178
Uerdingen,Ingolstadt,2019-08-17,0,3,3,n,0,1,1,0,1,0,2,2,0,2,0,3,3,5,4,4,5,9,3. Liga - Germany,3053179
Würzburger Kickers,Preußen Münster,2019-08-17,3,2,5,y,2,1,1,2,3,1,1,1,1,2,1,3,4,6,4,4,6,10,3. Liga - Germany,3053180
Kaiserslautern,Eintracht Braunschweig,2019-08-18,0,3,3,n,0,0,0,0,0,0,3,3,0,3,2,0,2,8,4,4,8,12,3. Liga - Germany,3053181
MSV Duisburg,Zwickau,2019-08-17,3,1,4,y,0,0,0,0,0,3,1,1,3,4,1,3,4,10,2,2,10,12,3. Liga - Germany,3053182
Carl Zeiss Jena,Waldhof Mannheim,2019-08-18,1,2,3,y,1,1,1,1,2,0,1,1,0,1,5,1,6,1,5,5,1,6,3. Liga - Germany,3053183
1860 München,Meppen,2019-08-17,0,0,0,n,0,0,0,0,0,0,0,0,0,0,1,3,4,7,5,5,7,12,3. Liga - Germany,3053184
Hallescher FC,Bayern München II,2019-08-19,1,2,3,y,1,1,1,1,2,0,1,1,0,1,3,0,3,3,7,7,3,10,3. Liga - Germany,3053185
Viktoria Köln,Unterhaching,2019-08-17,0,2,2,n,0,0,0,0,0,0,2,2,0,2,3,2,5,4,4,4,4,8,3. Liga - Germany,3053186
Hansa Rostock,Sonnenhof Großaspach,2019-08-17,0,1,1,n,0,0,0,0,0,0,1,1,0,1,1,2,3,5,4,4,5,9,3. Liga - Germany,3053187
Zwickau,Kaiserslautern,2019-08-26,3,5,8,y,0,2,2,0,2,3,3,3,3,6,2,6,8,2,9,9,2,11,3. Liga - Germany,3053188
Eintracht Braunschweig,Würzburger Kickers,2019-08-24,5,2,7,y,2,2,2,2,4,3,0,0,3,3,1,3,4,-1,-1,-1,-1,-1,3. Liga - Germany,3053189
Preußen Münster,Uerdingen,2019-08-24,1,1,2,y,0,0,0,0,0,1,1,1,1,2,3,4,7,3,7,7,3,10,3. Liga - Germany,3053190
Ingolstadt,Hansa Rostock,2019-08-23,2,2,4,y,1,0,0,1,1,1,2,2,1,3,2,3,5,7,7,7,7,14,3. Liga - Germany,3053191
Sonnenhof Großaspach,Viktoria Köln,2019-08-24,0,3,3,n,0,2,2,0,2,0,1,1,0,1,1,3,4,4,2,2,4,6,3. Liga - Germany,3053192
Unterhaching,Hallescher FC,2019-08-25,0,3,3,n,0,1,1,0,1,0,2,2,0,2,2,2,4,7,4,4,7,11,3. Liga - Germany,3053193
Bayern München II,Chemnitzer FC,2019-08-24,2,2,4,y,0,0,0,0,0,2,2,2,2,4,4,1,5,6,2,2,6,8,3. Liga - Germany,3053194
Magdeburg,1860 München,2019-08-24,5,1,6,y,4,0,0,4,4,1,1,1,1,2,3,1,4,-1,-1,-1,-1,-1,3. Liga - Germany,3053195
Meppen,Carl Zeiss Jena,2019-08-24,3,0,3,n,0,0,0,0,0,3,0,0,3,3,1,2,3,10,6,6,10,16,3. Liga - Germany,3053196
Waldhof Mannheim,MSV Duisburg,2019-08-25,4,3,7,y,2,2,2,2,4,2,1,1,2,3,2,1,3,4,5,5,4,9,3. Liga - Germany,3053197
Chemnitzer FC,1860 München,2019-08-30,0,1,1,n,0,0,0,0,0,0,1,1,0,1,1,4,5,4,4,4,4,8,3. Liga - Germany,3053198
Uerdingen,Eintracht Braunschweig,2019-09-01,1,2,3,y,0,0,0,0,0,1,2,2,1,3,4,4,8,3,1,1,3,4,3. Liga - Germany,3053199
Würzburger Kickers,Zwickau,2019-08-31,0,2,2,n,0,2,2,0,2,0,0,0,0,0,0,0,0,4,6,6,4,10,3. Liga - Germany,3053200
Kaiserslautern,Waldhof Mannheim,2019-09-01,1,1,2,y,1,1,1,1,2,0,0,0,0,0,2,1,3,10,7,7,10,17,3. Liga - Germany,3053201
MSV Duisburg,Meppen,2019-10-02,1,3,4,y,1,3,3,1,4,0,0,0,0,0,1,2,3,5,1,1,5,6,3. Liga - Germany,3053202
Carl Zeiss Jena,Magdeburg,2019-09-02,1,1,2,y,1,0,0,1,1,0,1,1,0,1,2,4,6,1,9,9,1,10,3. Liga - Germany,3053203
Bayern München II,Unterhaching,2019-08-31,1,2,3,y,1,1,1,1,2,0,1,1,0,1,3,2,5,6,1,1,6,7,3. Liga - Germany,3053204
Hallescher FC,Sonnenhof Großaspach,2019-08-31,4,0,4,n,2,0,0,2,2,2,0,0,2,2,0,2,2,8,3,3,8,11,3. Liga - Germany,3053205
Viktoria Köln,Ingolstadt,2019-08-31,3,0,3,n,2,0,0,2,2,1,0,0,1,1,1,4,5,3,8,8,3,11,3. Liga - Germany,3053206
Hansa Rostock,Preußen Münster,2019-08-31,1,0,1,n,0,0,0,0,0,1,0,0,1,1,2,1,3,10,5,5,10,15,3. Liga - Germany,3053207
Zwickau,Uerdingen,2019-09-14,1,2,3,y,0,1,1,0,1,1,1,1,1,2,1,3,4,11,6,6,11,17,3. Liga - Germany,3053208
Eintracht Braunschweig,Hansa Rostock,2019-09-15,1,2,3,y,1,2,2,1,3,0,0,0,0,0,2,1,3,3,1,1,3,4,3. Liga - Germany,3053209
Preußen Münster,Viktoria Köln,2019-09-14,2,3,5,y,0,2,2,0,2,2,1,1,2,3,5,1,6,8,5,5,8,13,3. Liga - Germany,3053210
Ingolstadt,Hallescher FC,2019-09-15,2,3,5,y,0,0,0,0,0,2,3,3,2,5,1,4,5,5,3,3,5,8,3. Liga - Germany,3053211
Sonnenhof Großaspach,Bayern München II,2019-09-14,2,2,4,y,0,2,2,0,2,2,0,0,2,2,0,3,3,4,5,5,4,9,3. Liga - Germany,3053212
Unterhaching,Chemnitzer FC,2019-09-16,2,1,3,y,1,0,0,1,1,1,1,1,1,2,4,2,6,5,5,5,5,10,3. Liga - Germany,3053213
1860 München,Carl Zeiss Jena,2019-09-14,3,1,4,y,2,0,0,2,2,1,1,1,1,2,0,0,0,9,5,5,9,14,3. Liga - Germany,3053214
Magdeburg,MSV Duisburg,2019-09-13,1,1,2,y,0,1,1,0,1,1,0,0,1,1,3,7,10,5,4,4,5,9,3. Liga - Germany,3053215
Meppen,Kaiserslautern,2019-09-14,6,1,7,y,3,1,1,3,4,3,0,0,3,3,0,2,2,3,13,13,3,16,3. Liga - Germany,3053216
Waldhof Mannheim,Würzburger Kickers,2019-09-14,1,2,3,y,1,1,1,1,2,0,1,1,0,1,2,1,3,7,9,9,7,16,3. Liga - Germany,3053217
Chemnitzer FC,Carl Zeiss Jena,2019-09-21,3,2,5,y,1,1,1,1,2,2,1,1,2,3,2,4,6,3,10,10,3,13,3. Liga - Germany,3053218
Uerdingen,Waldhof Mannheim,2019-09-23,0,3,3,n,0,0,0,0,0,0,3,3,0,3,2,1,3,6,2,2,6,8,3. Liga - Germany,3053219
Würzburger Kickers,Meppen,2019-09-20,3,2,5,y,3,1,1,3,4,0,1,1,0,1,3,6,9,6,4,4,6,10,3. Liga - Germany,3053220
Kaiserslautern,Magdeburg,2019-09-21,1,1,2,y,0,0,0,0,0,1,1,1,1,2,1,0,1,5,7,7,5,12,3. Liga - Germany,3053221
MSV Duisburg,1860 München,2019-09-21,2,1,3,y,1,1,1,1,2,1,0,0,1,1,0,2,2,4,3,3,4,7,3. Liga - Germany,3053222
Unterhaching,Sonnenhof Großaspach,2019-09-21,2,0,2,n,2,0,0,2,2,0,0,0,0,0,5,3,8,-1,-1,-1,-1,-1,3. Liga - Germany,3053223
Bayern München II,Ingolstadt,2019-09-22,2,1,3,y,1,1,1,1,2,1,0,0,1,1,1,3,4,7,4,4,7,11,3. Liga - Germany,3053224
Hallescher FC,Preußen Münster,2019-09-21,2,2,4,y,0,0,0,0,0,2,2,2,2,4,3,4,7,6,4,4,6,10,3. Liga - Germany,3053225
Viktoria Köln,Eintracht Braunschweig,2019-09-21,0,0,0,n,0,0,0,0,0,0,0,0,0,0,2,2,4,2,8,8,2,10,3. Liga - Germany,3053226
Hansa Rostock,Zwickau,2019-09-22,1,1,2,y,1,0,0,1,1,0,1,1,0,1,1,1,2,3,4,4,3,7,3. Liga - Germany,3053227
Zwickau,Viktoria Köln,2019-09-28,4,0,4,n,3,0,0,3,3,1,0,0,1,1,3,5,8,7,1,1,7,8,3. Liga - Germany,3053228
Eintracht Braunschweig,Hallescher FC,2019-09-28,1,1,2,y,1,0,0,1,1,0,1,1,0,1,1,3,4,6,2,2,6,8,3. Liga - Germany,3053229
Preußen Münster,Bayern München II,2019-09-28,1,4,5,y,0,4,4,0,4,1,0,0,1,1,5,1,6,9,1,1,9,10,3. Liga - Germany,3053230
Ingolstadt,Unterhaching,2019-09-30,0,0,0,n,0,0,0,0,0,0,0,0,0,0,1,1,2,7,11,11,7,18,3. Liga - Germany,3053231
Sonnenhof Großaspach,Chemnitzer FC,2019-09-28,2,0,2,n,1,0,0,1,1,1,0,0,1,1,1,4,5,5,14,14,5,19,3. Liga - Germany,3053232
Carl Zeiss Jena,MSV Duisburg,2019-09-28,1,2,3,y,0,0,0,0,0,1,2,2,1,3,3,1,4,9,6,6,9,15,3. Liga - Germany,3053233
1860 München,Kaiserslautern,2019-09-28,3,1,4,y,1,0,0,1,1,2,1,1,2,3,1,4,5,4,12,12,4,16,3. Liga - Germany,3053234
Magdeburg,Würzburger Kickers,2019-09-27,3,0,3,n,1,0,0,1,1,2,0,0,2,2,4,1,5,-1,-1,-1,-1,-1,3. Liga - Germany,3053235
Meppen,Uerdingen,2019-09-29,1,2,3,y,0,1,1,0,1,1,1,1,1,2,3,2,5,8,4,4,8,12,3. Liga - Germany,3053236
Waldhof Mannheim,Hansa Rostock,2019-09-29,1,1,2,y,0,0,0,0,0,1,1,1,1,2,0,2,2,5,4,4,5,9,3. Liga - Germany,3053237
Chemnitzer FC,MSV Duisburg,2019-10-06,3,1,4,y,0,0,0,0,0,3,1,1,3,4,0,2,2,5,2,2,5,7,3. Liga - Germany,3053238
Uerdingen,Magdeburg,2019-10-04,0,0,0,n,0,0,0,0,0,0,0,0,0,0,2,1,3,8,5,5,8,13,3. Liga - Germany,3053239
Würzburger Kickers,1860 München,2019-10-07,2,1,3,y,1,0,0,1,1,1,1,1,1,2,4,4,8,1,3,3,1,4,3. Liga - Germany,3053240
Kaiserslautern,Carl Zeiss Jena,2019-10-05,3,1,4,y,1,1,1,1,2,2,0,0,2,2,4,1,5,10,5,5,10,15,3. Liga - Germany,3053241
Sonnenhof Großaspach,Ingolstadt,2019-10-05,1,5,6,y,1,3,3,1,4,0,2,2,0,2,1,2,3,2,9,9,2,11,3. Liga - Germany,3053242
Unterhaching,Preußen Münster,2019-10-05,2,2,4,y,2,0,0,2,2,0,2,2,0,2,2,3,5,3,6,6,3,9,3. Liga - Germany,3053243
Bayern München II,Eintracht Braunschweig,2019-10-06,2,0,2,n,1,0,0,1,1,1,0,0,1,1,3,3,6,6,7,7,6,13,3. Liga - Germany,3053244
Hallescher FC,Zwickau,2019-10-05,1,1,2,y,0,1,1,0,1,1,0,0,1,1,1,3,4,3,2,2,3,5,3. Liga - Germany,3053245
Viktoria Köln,Waldhof Mannheim,2019-10-05,2,2,4,y,2,2,2,2,4,0,0,0,0,0,3,0,3,5,2,2,5,7,3. Liga - Germany,3053246
Hansa Rostock,Meppen,2019-10-05,2,1,3,y,2,0,0,2,2,0,1,1,0,1,6,2,8,2,1,1,2,3,3. Liga - Germany,3053247
Zwickau,Bayern München II,2019-10-20,3,0,3,n,1,0,0,1,1,2,0,0,2,2,2,3,5,5,6,6,5,11,3. Liga - Germany,3053248
Eintracht Braunschweig,Unterhaching,2019-10-19,0,0,0,n,0,0,0,0,0,0,0,0,0,0,0,5,5,10,1,1,10,11,3. Liga - Germany,3053249
Preußen Münster,Sonnenhof Großaspach,2019-10-19,1,1,2,y,1,0,0,1,1,0,1,1,0,1,5,5,10,4,5,5,4,9,3. Liga - Germany,3053250
Ingolstadt,Chemnitzer FC,2019-10-19,1,1,2,y,1,0,0,1,1,0,1,1,0,1,3,1,4,5,6,6,5,11,3. Liga - Germany,3053251
MSV Duisburg,Kaiserslautern,2019-10-18,3,1,4,y,2,0,0,2,2,1,1,1,1,2,2,1,3,5,6,6,5,11,3. Liga - Germany,3053252
Carl Zeiss Jena,Würzburger Kickers,2019-10-20,1,1,2,y,0,0,0,0,0,1,1,1,1,2,1,2,3,2,6,6,2,8,3. Liga - Germany,3053253
1860 München,Uerdingen,2019-10-19,0,1,1,n,0,0,0,0,0,0,1,1,0,1,4,4,8,4,5,5,4,9,3. Liga - Germany,3053254
Magdeburg,Hansa Rostock,2019-10-19,0,1,1,n,0,1,1,0,1,0,0,0,0,0,3,1,4,4,2,2,4,6,3. Liga - Germany,3053255
Meppen,Viktoria Köln,2019-10-21,1,1,2,y,1,0,0,1,1,0,1,1,0,1,3,3,6,7,0,0,7,7,3. Liga - Germany,3053256
Waldhof Mannheim,Hallescher FC,2019-10-19,0,4,4,n,0,2,2,0,2,0,2,2,0,2,4,5,9,1,5,5,1,6,3. Liga - Germany,3053257
Chemnitzer FC,Kaiserslautern,2019-10-27,3,1,4,y,3,1,1,3,4,0,0,0,0,0,7,2,9,6,3,3,6,9,3. Liga - Germany,3053258
Uerdingen,Carl Zeiss Jena,2019-10-26,2,0,2,n,1,0,0,1,1,1,0,0,1,1,2,4,6,4,6,6,4,10,3. Liga - Germany,3053259
Würzburger Kickers,MSV Duisburg,2019-10-26,0,2,2,n,0,2,2,0,2,0,0,0,0,0,2,3,5,5,5,5,5,10,3. Liga - Germany,3053260
Ingolstadt,Preußen Münster,2019-10-26,3,2,5,y,1,2,2,1,3,2,0,0,2,2,2,1,3,12,4,4,12,16,3. Liga - Germany,3053261
Sonnenhof Großaspach,Eintracht Braunschweig,2019-10-27,1,3,4,y,1,2,2,1,3,0,1,1,0,1,2,6,8,8,1,1,8,9,3. Liga - Germany,3053262
Unterhaching,Zwickau,2019-10-26,0,0,0,n,0,0,0,0,0,0,0,0,0,0,2,2,4,4,7,7,4,11,3. Liga - Germany,3053263
Bayern München II,Waldhof Mannheim,2019-10-28,2,2,4,y,1,0,0,1,1,1,2,2,1,3,2,5,7,8,5,5,8,13,3. Liga - Germany,3053264
Hallescher FC,Meppen,2019-10-26,3,3,6,y,2,2,2,2,4,1,1,1,1,2,2,4,6,12,4,4,12,16,3. Liga - Germany,3053265
Viktoria Köln,Magdeburg,2019-10-25,1,1,2,y,1,1,1,1,2,0,0,0,0,0,3,3,6,2,8,8,2,10,3. Liga - Germany,3053266
Hansa Rostock,1860 München,2019-10-26,2,1,3,y,1,0,0,1,1,1,1,1,1,2,4,2,6,4,3,3,4,7,3. Liga - Germany,3053267
Zwickau,Sonnenhof Großaspach,2019-11-01,0,1,1,n,0,0,0,0,0,0,1,1,0,1,1,1,2,13,9,9,13,22,3. Liga - Germany,3053268
Eintracht Braunschweig,Ingolstadt,2019-11-02,0,3,3,n,0,3,3,0,3,0,0,0,0,0,2,0,2,-1,-1,-1,-1,-1,3. Liga - Germany,3053269
Preußen Münster,Chemnitzer FC,2019-11-02,3,3,6,y,2,2,2,2,4,1,1,1,1,2,3,4,7,2,5,5,2,7,3. Liga - Germany,3053270
Kaiserslautern,Würzburger Kickers,2019-11-02,2,3,5,y,1,1,1,1,2,1,2,2,1,3,3,5,8,1,6,6,1,7,3. Liga - Germany,3053271
MSV Duisburg,Uerdingen,2019-11-04,2,0,2,n,2,0,0,2,2,0,0,0,0,0,1,4,5,4,6,6,4,10,3. Liga - Germany,3053272
Carl Zeiss Jena,Hansa Rostock,2019-11-03,3,1,4,y,1,0,0,1,1,2,1,1,2,3,2,2,4,3,8,8,3,11,3. Liga - Germany,3053273
1860 München,Viktoria Köln,2019-11-02,4,2,6,y,2,0,0,2,2,2,2,2,2,4,0,1,1,2,2,2,2,4,3. Liga - Germany,3053274
Magdeburg,Hallescher FC,2019-11-02,1,0,1,n,1,0,0,1,1,0,0,0,0,0,0,1,1,2,4,4,2,6,3. Liga - Germany,3053275
Meppen,Bayern München II,2019-11-03,5,3,8,y,1,1,1,1,2,4,2,2,4,6,5,3,8,-1,-1,-1,-1,-1,3. Liga - Germany,3053276
Waldhof Mannheim,Unterhaching,2019-11-02,0,3,3,n,0,1,1,0,1,0,2,2,0,2,1,3,4,8,3,3,8,11,3. Liga - Germany,3053277
Chemnitzer FC,Würzburger Kickers,2019-11-10,0,0,0,n,0,0,0,0,0,0,0,0,0,0,1,0,1,6,5,5,6,11,3. Liga - Germany,3053278
Uerdingen,Kaiserslautern,2019-11-09,0,3,3,n,0,1,1,0,1,0,2,2,0,2,3,0,3,3,10,10,3,13,3. Liga - Germany,3053279
Preußen Münster,Eintracht Braunschweig,2019-11-11,1,1,2,y,0,0,0,0,0,1,1,1,1,2,2,5,7,7,5,5,7,12,3. Liga - Germany,3053280
Ingolstadt,Zwickau,2019-11-09,4,2,6,y,3,2,2,3,5,1,0,0,1,1,1,3,4,7,7,7,7,14,3. Liga - Germany,3053281
Sonnenhof Großaspach,Waldhof Mannheim,2019-11-09,0,3,3,n,0,1,1,0,1,0,2,2,0,2,2,3,5,2,8,8,2,10,3. Liga - Germany,3053282
Unterhaching,Meppen,2019-11-09,0,0,0,n,0,0,0,0,0,0,0,0,0,0,3,3,6,3,9,9,3,12,3. Liga - Germany,3053283
Bayern München II,Magdeburg,2019-11-10,2,1,3,y,2,0,0,2,2,0,1,1,0,1,1,1,2,3,8,8,3,11,3. Liga - Germany,3053284
Hallescher FC,1860 München,2019-11-09,0,1,1,n,0,1,1,0,1,0,0,0,0,0,0,1,1,7,2,2,7,9,3. Liga - Germany,3053285
Viktoria Köln,Carl Zeiss Jena,2019-11-08,2,2,4,y,0,1,1,0,1,2,1,1,2,3,3,1,4,5,4,4,5,9,3. Liga - Germany,3053286
Hansa Rostock,MSV Duisburg,2019-11-09,1,2,3,y,0,0,0,0,0,1,2,2,1,3,0,0,0,10,2,2,10,12,3. Liga - Germany,3053287
Zwickau,Preußen Münster,2019-11-23,4,2,6,y,2,1,1,2,3,2,1,1,2,3,1,5,6,10,10,10,10,20,3. Liga - Germany,3053288
Eintracht Braunschweig,Chemnitzer FC,2019-11-23,2,1,3,y,0,1,1,0,1,2,0,0,2,2,2,3,5,7,10,10,7,17,3. Liga - Germany,3053289
Würzburger Kickers,Uerdingen,2019-11-23,1,2,3,y,0,1,1,0,1,1,1,1,1,2,2,1,3,8,3,3,8,11,3. Liga - Germany,3053290
Kaiserslautern,Hansa Rostock,2019-11-24,2,0,2,n,2,0,0,2,2,0,0,0,0,0,0,4,4,5,1,1,5,6,3. Liga - Germany,3053291
MSV Duisburg,Viktoria Köln,2019-11-25,2,1,3,y,1,1,1,1,2,1,0,0,1,1,1,1,2,5,2,2,5,7,3. Liga - Germany,3053292
Carl Zeiss Jena,Hallescher FC,2019-11-22,0,3,3,n,0,1,1,0,1,0,2,2,0,2,2,3,5,8,7,7,8,15,3. Liga - Germany,3053293
1860 München,Bayern München II,2019-11-24,1,1,2,y,0,1,1,0,1,1,0,0,1,1,2,2,4,9,4,4,9,13,3. Liga - Germany,3053294
Magdeburg,Unterhaching,2019-11-23,3,0,3,n,2,0,0,2,2,1,0,0,1,1,2,2,4,9,2,2,9,11,3. Liga - Germany,3053295
Meppen,Sonnenhof Großaspach,2019-11-23,2,1,3,y,1,0,0,1,1,1,1,1,1,2,2,5,7,4,9,9,4,13,3. Liga - Germany,3053296
Waldhof Mannheim,Ingolstadt,2019-11-23,0,0,0,n,0,0,0,0,0,0,0,0,0,0,2,1,3,8,4,4,8,12,3. Liga - Germany,3053297
Chemnitzer FC,Uerdingen,2019-11-30,1,1,2,y,0,0,0,0,0,1,1,1,1,2,2,5,7,5,2,2,5,7,3. Liga - Germany,3053298
Eintracht Braunschweig,Zwickau,2019-12-02,3,1,4,y,2,0,0,2,2,1,1,1,1,2,3,1,4,10,7,7,10,17,3. Liga - Germany,3053299
Preußen Münster,Waldhof Mannheim,2019-11-30,1,3,4,y,1,0,0,1,1,0,3,3,0,3,4,1,5,4,10,10,4,14,3. Liga - Germany,3053300
Ingolstadt,Meppen,2019-12-01,1,1,2,y,1,0,0,1,1,0,1,1,0,1,2,2,4,4,5,5,4,9,3. Liga - Germany,3053301
Sonnenhof Großaspach,Magdeburg,2019-11-30,1,2,3,y,0,1,1,0,1,1,1,1,1,2,4,0,4,2,11,11,2,13,3. Liga - Germany,3053302
Unterhaching,1860 München,2019-12-01,2,3,5,y,1,1,1,1,2,1,2,2,1,3,3,2,5,0,7,7,0,7,3. Liga - Germany,3053303
Bayern München II,Carl Zeiss Jena,2019-11-29,2,3,5,y,1,2,2,1,3,1,1,1,1,2,3,3,6,1,1,1,1,2,3. Liga - Germany,3053304
Hallescher FC,MSV Duisburg,2019-11-30,1,0,1,n,0,0,0,0,0,1,0,0,1,1,2,2,4,2,3,3,2,5,3. Liga - Germany,3053305
Viktoria Köln,Kaiserslautern,2019-11-30,2,4,6,y,0,2,2,0,2,2,2,2,2,4,3,2,5,4,4,4,4,8,3. Liga - Germany,3053306
Hansa Rostock,Würzburger Kickers,2019-11-30,1,0,1,n,1,0,0,1,1,0,0,0,0,0,3,0,3,2,6,6,2,8,3. Liga - Germany,3053307
Chemnitzer FC,Zwickau,2019-12-06,2,2,4,y,2,2,2,2,4,0,0,0,0,0,2,6,8,6,5,5,6,11,3. Liga - Germany,3053308
Uerdingen,Hansa Rostock,2019-12-07,4,1,5,y,2,1,1,2,3,2,0,0,2,2,2,4,6,6,9,9,6,15,3. Liga - Germany,3053309
Würzburger Kickers,Viktoria Köln,2019-12-07,3,1,4,y,0,0,0,0,0,3,1,1,3,4,2,3,5,6,1,1,6,7,3. Liga - Germany,3053310
Kaiserslautern,Hallescher FC,2019-12-07,1,0,1,n,0,0,0,0,0,1,0,0,1,1,1,1,2,10,3,3,10,13,3. Liga - Germany,3053311
MSV Duisburg,Bayern München II,2019-12-08,3,2,5,y,2,0,0,2,2,1,2,2,1,3,1,2,3,5,7,7,5,12,3. Liga - Germany,3053312
Carl Zeiss Jena,Unterhaching,2019-12-07,0,3,3,n,0,2,2,0,2,0,1,1,0,1,3,4,7,4,6,6,4,10,3. Liga - Germany,3053313
1860 München,Sonnenhof Großaspach,2019-12-07,1,1,2,y,1,0,0,1,1,0,1,1,0,1,3,5,8,4,5,5,4,9,3. Liga - Germany,3053314
Magdeburg,Ingolstadt,2019-12-07,0,2,2,n,0,1,1,0,1,0,1,1,0,1,1,3,4,12,2,2,12,14,3. Liga - Germany,3053315
Meppen,Preußen Münster,2019-12-09,3,1,4,y,1,0,0,1,1,2,1,1,2,3,2,2,4,10,4,4,10,14,3. Liga - Germany,3053316
Waldhof Mannheim,Eintracht Braunschweig,2019-12-08,0,0,0,n,0,0,0,0,0,0,0,0,0,0,1,3,4,4,2,2,4,6,3. Liga - Germany,3053317
Zwickau,Waldhof Mannheim,2019-12-14,0,1,1,n,0,1,1,0,1,0,0,0,0,0,2,1,3,9,3,3,9,12,3. Liga - Germany,3053318
Eintracht Braunschweig,Meppen,2019-12-14,1,2,3,y,1,2,2,1,3,0,0,0,0,0,4,2,6,5,2,2,5,7,3. Liga - Germany,3053319
Preußen Münster,Magdeburg,2019-12-13,2,0,2,n,1,0,0,1,1,1,0,0,1,1,3,3,6,2,6,6,2,8,3. Liga - Germany,3053320
Ingolstadt,1860 München,2019-12-16,2,2,4,y,1,2,2,1,3,1,0,0,1,1,2,1,3,6,3,3,6,9,3. Liga - Germany,3053321
Sonnenhof Großaspach,Carl Zeiss Jena,2019-12-15,1,2,3,y,0,2,2,0,2,1,0,0,1,1,3,1,4,8,4,4,8,12,3. Liga - Germany,3053322
Unterhaching,MSV Duisburg,2019-12-15,2,2,4,y,2,2,2,2,4,0,0,0,0,0,1,4,5,4,3,3,4,7,3. Liga - Germany,3053323
Bayern München II,Kaiserslautern,2019-12-14,1,3,4,y,1,1,1,1,2,0,2,2,0,2,3,0,3,-1,-1,-1,-1,-1,3. Liga - Germany,3053324
Hallescher FC,Würzburger Kickers,2019-12-14,2,5,7,y,1,3,3,1,4,1,2,2,1,3,3,1,4,4,11,11,4,15,3. Liga - Germany,3053325
Viktoria Köln,Uerdingen,2019-12-14,0,1,1,n,0,0,0,0,0,0,1,1,0,1,2,2,4,5,5,5,5,10,3. Liga - Germany,3053326
Hansa Rostock,Chemnitzer FC,2019-12-14,1,2,3,y,1,1,1,1,2,0,1,1,0,1,3,1,4,2,4,4,2,6,3. Liga - Germany,3053327
Waldhof Mannheim,Chemnitzer FC,2019-12-21,4,3,7,y,2,3,3,2,5,2,0,0,2,2,5,4,9,6,3,3,6,9,3. Liga - Germany,3053328
Hallescher FC,Uerdingen,2019-12-22,1,1,2,y,0,0,0,0,0,1,1,1,1,2,2,1,3,4,3,3,4,7,3. Liga - Germany,3053329
Unterhaching,Kaiserslautern,2019-12-21,1,1,2,y,1,0,0,1,1,0,1,1,0,1,2,4,6,6,7,7,6,13,3. Liga - Germany,3053331
Sonnenhof Großaspach,MSV Duisburg,2019-12-21,1,1,2,y,1,0,0,1,1,0,1,1,0,1,2,0,2,4,7,7,4,11,3. Liga - Germany,3053332
Ingolstadt,Carl Zeiss Jena,2019-12-22,5,1,6,y,2,0,0,2,2,3,1,1,3,4,2,6,8,3,5,5,3,8,3. Liga - Germany,3053333
Preußen Münster,1860 München,2019-12-21,0,1,1,n,0,0,0,0,0,0,1,1,0,1,4,4,8,3,3,3,3,6,3. Liga - Germany,3053334
Eintracht Braunschweig,Magdeburg,2019-12-21,2,2,4,y,0,0,0,0,0,2,2,2,2,4,4,2,6,11,2,2,11,13,3. Liga - Germany,3053335
Zwickau,Meppen,2019-12-21,2,2,4,y,2,0,0,2,2,0,2,2,0,2,3,1,4,7,15,15,7,22,3. Liga - Germany,3053336
Viktoria Köln,Hansa Rostock,2019-12-20,1,5,6,y,0,3,3,0,3,1,2,2,1,3,3,0,3,4,4,4,4,8,3. Liga - Germany,3053337
Bayern München II,Würzburger Kickers,2019-12-22,1,1,2,y,0,0,0,0,0,1,1,1,1,2,4,1,5,4,13,13,4,17,3. Liga - Germany,3053330
Magdeburg,Zwickau,2020-01-25,1,2,3,y,1,0,0,1,1,0,2,2,0,2,1,2,3,4,2,2,4,6,3. Liga - Germany,3053338
Würzburger Kickers,Unterhaching,2020-01-25,1,2,3,y,0,0,0,0,0,1,2,2,1,3,3,3,6,13,2,2,13,15,3. Liga - Germany,3053343
Meppen,Waldhof Mannheim,2020-01-25,0,1,1,n,0,1,1,0,1,0,0,0,0,0,2,5,7,6,1,1,6,7,3. Liga - Germany,3053347
Hansa Rostock,Hallescher FC,2020-01-24,1,0,1,n,0,0,0,0,0,1,0,0,1,1,0,0,0,5,10,10,5,15,3. Liga - Germany,3053345
MSV Duisburg,Ingolstadt,2020-01-25,1,1,2,y,0,0,0,0,0,1,1,1,1,2,1,2,3,6,3,3,6,9,3. Liga - Germany,3053341
Chemnitzer FC,Viktoria Köln,2020-01-25,2,2,4,y,2,2,2,2,4,0,0,0,0,0,3,3,6,5,3,3,5,8,3. Liga - Germany,3053346
1860 München,Eintracht Braunschweig,2020-01-26,4,1,5,y,2,1,1,2,3,2,0,0,2,2,0,2,2,8,2,2,8,10,3. Liga - Germany,3053339
Uerdingen,Bayern München II,2020-01-26,0,3,3,n,0,2,2,0,2,0,1,1,0,1,5,2,7,1,7,7,1,8,3. Liga - Germany,3053344
Carl Zeiss Jena,Preußen Münster,2020-01-25,1,2,3,y,0,1,1,0,1,1,1,1,1,2,6,3,9,4,5,5,4,9,3. Liga - Germany,3053340
Kaiserslautern,Sonnenhof Großaspach,2020-01-27,0,0,0,n,0,0,0,0,0,0,0,0,0,0,3,5,8,10,2,2,10,12,3. Liga - Germany,3053342
Unterhaching,Uerdingen,2020-02-01,1,0,1,n,1,0,0,1,1,0,0,0,0,0,4,2,6,2,8,8,2,10,3. Liga - Germany,3053349
Ingolstadt,Kaiserslautern,2020-02-01,2,1,3,y,0,0,0,0,0,2,1,1,2,3,0,3,3,3,8,8,3,11,3. Liga - Germany,3053351
Preußen Münster,MSV Duisburg,2020-02-01,1,4,5,y,1,2,2,1,3,0,2,2,0,2,3,3,6,8,7,7,8,15,3. Liga - Germany,3053352
Eintracht Braunschweig,Carl Zeiss Jena,2020-02-01,1,1,2,y,0,1,1,0,1,1,0,0,1,1,4,5,9,5,3,3,5,8,3. Liga - Germany,3053353
Zwickau,1860 München,2020-02-02,2,2,4,y,1,1,1,1,2,1,1,1,1,2,4,6,10,4,5,5,4,9,3. Liga - Germany,3053354
Hallescher FC,Viktoria Köln,2020-01-31,3,4,7,y,0,1,1,0,1,3,3,3,3,6,1,3,4,3,1,1,3,4,3. Liga - Germany,3053356
Bayern München II,Hansa Rostock,2020-02-01,1,0,1,n,1,0,0,1,1,0,0,0,0,0,2,4,6,10,1,1,10,11,3. Liga - Germany,3053357
Sonnenhof Großaspach,Würzburger Kickers,2020-02-03,0,6,6,n,0,2,2,0,2,0,4,4,0,4,4,1,5,2,6,6,2,8,3. Liga - Germany,3053350
Meppen,Chemnitzer FC,2020-02-01,1,2,3,y,1,0,0,1,1,0,2,2,0,2,4,2,6,7,1,1,7,8,3. Liga - Germany,3053348
Waldhof Mannheim,Magdeburg,2020-02-02,1,1,2,y,0,0,0,0,0,1,1,1,1,2,3,4,7,0,7,7,0,7,3. Liga - Germany,3053355
MSV Duisburg,Eintracht Braunschweig,2020-02-07,1,1,2,y,0,1,1,0,1,1,0,0,1,1,2,4,6,9,1,1,9,10,3. Liga - Germany,3053359
Kaiserslautern,Preußen Münster,2020-02-08,1,1,2,y,1,1,1,1,2,0,0,0,0,0,1,1,2,6,0,0,6,6,3. Liga - Germany,3053360
Würzburger Kickers,Ingolstadt,2020-02-09,3,1,4,y,0,1,1,0,1,3,0,0,3,3,2,6,8,8,5,5,8,13,3. Liga - Germany,3053361
Uerdingen,Sonnenhof Großaspach,2020-02-08,2,1,3,y,0,0,0,0,0,2,1,1,2,3,5,3,8,9,4,4,9,13,3. Liga - Germany,3053362
Viktoria Köln,Bayern München II,2020-02-08,2,4,6,y,0,1,1,0,1,2,3,3,2,5,5,2,7,5,7,7,5,12,3. Liga - Germany,3053364
Chemnitzer FC,Hallescher FC,2020-02-09,3,0,3,n,0,0,0,0,0,3,0,0,3,3,4,6,10,4,6,6,4,10,3. Liga - Germany,3053365
1860 München,Waldhof Mannheim,2020-02-08,1,1,2,y,0,0,0,0,0,1,1,1,1,2,1,1,2,7,4,4,7,11,3. Liga - Germany,3053367
Magdeburg,Meppen,2020-02-08,0,2,2,n,0,0,0,0,0,0,2,2,0,2,1,4,5,2,3,3,2,5,3. Liga - Germany,3053366
Hansa Rostock,Unterhaching,2020-02-08,1,1,2,y,0,0,0,0,0,1,1,1,1,2,1,2,3,8,2,2,8,10,3. Liga - Germany,3053363
Carl Zeiss Jena,Zwickau,2020-02-10,2,1,3,y,0,1,1,0,1,2,0,0,2,2,2,4,6,9,5,5,9,14,3. Liga - Germany,3053358
Magdeburg,Chemnitzer FC,2020-02-15,1,1,2,y,0,1,1,0,1,1,0,0,1,1,3,5,8,3,3,3,3,6,3. Liga - Germany,3053368
Ingolstadt,Uerdingen,2020-02-15,0,1,1,n,0,0,0,0,0,0,1,1,0,1,1,4,5,3,3,3,3,6,3. Liga - Germany,3053369
Preußen Münster,Würzburger Kickers,2020-02-14,0,0,0,n,0,0,0,0,0,0,0,0,0,0,6,2,8,4,6,6,4,10,3. Liga - Germany,3053370
Eintracht Braunschweig,Kaiserslautern,2020-02-15,2,0,2,n,2,0,0,2,2,0,0,0,0,0,3,1,4,2,11,11,2,13,3. Liga - Germany,3053371
Zwickau,MSV Duisburg,2020-02-16,1,0,1,n,0,0,0,0,0,1,0,0,1,1,4,0,4,6,5,5,6,11,3. Liga - Germany,3053372
Waldhof Mannheim,Carl Zeiss Jena,2020-02-16,1,1,2,y,0,1,1,0,1,1,0,0,1,1,2,1,3,4,4,4,4,8,3. Liga - Germany,3053373
Meppen,1860 München,2020-02-15,1,1,2,y,1,0,0,1,1,0,1,1,0,1,3,4,7,6,4,4,6,10,3. Liga - Germany,3053374
Unterhaching,Viktoria Köln,2020-02-15,1,1,2,y,0,1,1,0,1,1,0,0,1,1,2,5,7,4,6,6,4,10,3. Liga - Germany,3053376
Sonnenhof Großaspach,Hansa Rostock,2020-02-15,0,1,1,n,0,1,1,0,1,0,0,0,0,0,1,1,2,2,7,7,2,9,3. Liga - Germany,3053377
Bayern München II,Hallescher FC,2020-02-17,6,1,7,y,2,1,1,2,3,4,0,0,4,4,1,2,3,3,4,4,3,7,3. Liga - Germany,3053375
Kaiserslautern,Zwickau,2020-02-22,0,0,0,n,0,0,0,0,0,0,0,0,0,0,4,3,7,6,1,1,6,7,3. Liga - Germany,3053378
Uerdingen,Preußen Münster,2020-02-22,0,2,2,n,0,1,1,0,1,0,1,1,0,1,2,2,4,2,8,8,2,10,3. Liga - Germany,3053380
Viktoria Köln,Sonnenhof Großaspach,2020-02-21,1,0,1,n,1,0,0,1,1,0,0,0,0,0,4,0,4,6,9,9,6,15,3. Liga - Germany,3053382
1860 München,Magdeburg,2020-02-23,1,1,2,y,1,0,0,1,1,0,1,1,0,1,5,7,12,6,4,4,6,10,3. Liga - Germany,3053385
Hansa Rostock,Ingolstadt,2020-02-22,3,0,3,n,2,0,0,2,2,1,0,0,1,1,2,0,2,3,7,7,3,10,3. Liga - Germany,3053381
Hallescher FC,Unterhaching,2020-02-23,3,5,8,y,1,2,2,1,3,2,3,3,2,5,1,1,2,9,4,4,9,13,3. Liga - Germany,3053383
Carl Zeiss Jena,Meppen,2020-02-22,0,2,2,n,0,1,1,0,1,0,1,1,0,1,4,2,6,1,7,7,1,8,3. Liga - Germany,3053386
Würzburger Kickers,Eintracht Braunschweig,2020-02-22,3,1,4,y,2,0,0,2,2,1,1,1,1,2,1,2,3,5,4,4,5,9,3. Liga - Germany,3053379
MSV Duisburg,Waldhof Mannheim,2020-02-22,2,3,5,y,2,0,0,2,2,0,3,3,0,3,1,1,2,2,5,5,2,7,3. Liga - Germany,3053387
Chemnitzer FC,Bayern München II,2020-02-24,1,0,1,n,1,0,0,1,1,0,0,0,0,0,4,3,7,3,6,6,3,9,3. Liga - Germany,3053384
1860 München,Chemnitzer FC,2020-02-29,4,3,7,y,1,2,2,1,3,3,1,1,3,4,5,7,12,4,3,3,4,7,3. Liga - Germany,3053388
Zwickau,Würzburger Kickers,2020-02-29,1,2,3,y,1,0,0,1,1,0,2,2,0,2,2,5,7,4,7,7,4,11,3. Liga - Germany,3053390
Waldhof Mannheim,Kaiserslautern,2020-02-29,1,1,2,y,0,0,0,0,0,1,1,1,1,2,2,2,4,10,8,8,10,18,3. Liga - Germany,3053391
Sonnenhof Großaspach,Hallescher FC,2020-02-29,1,0,1,n,0,0,0,0,0,1,0,0,1,1,2,3,5,4,6,6,4,10,3. Liga - Germany,3053395
Eintracht Braunschweig,Uerdingen,2020-02-29,4,1,5,y,3,0,0,3,3,1,1,1,1,2,1,5,6,2,5,5,2,7,3. Liga - Germany,3053389
Meppen,MSV Duisburg,2020-03-01,1,0,1,n,0,0,0,0,0,1,0,0,1,1,3,1,4,9,9,9,9,18,3. Liga - Germany,3053392
Magdeburg,Carl Zeiss Jena,2020-02-29,6,2,8,y,2,1,1,2,3,4,1,1,4,5,2,3,5,6,6,6,6,12,3. Liga - Germany,3053393
Unterhaching,Bayern München II,2020-02-28,0,1,1,n,0,1,1,0,1,0,0,0,0,0,5,3,8,2,5,5,2,7,3. Liga - Germany,3053394
Ingolstadt,Viktoria Köln,2020-03-01,0,1,1,n,0,0,0,0,0,0,1,1,0,1,1,3,4,10,4,4,10,14,3. Liga - Germany,3053396
Preußen Münster,Hansa Rostock,2020-03-02,1,0,1,n,0,0,0,0,0,1,0,0,1,1,2,2,4,-1,-1,-1,-1,-1,3. Liga - Germany,3053397
Bayern München II,Sonnenhof Großaspach,2020-03-07,2,0,2,n,0,0,0,0,0,2,0,0,2,2,1,2,3,8,1,1,8,9,3. Liga - Germany,3053402
Chemnitzer FC,Unterhaching,2020-03-07,1,0,1,n,1,0,0,1,1,0,0,0,0,0,2,4,6,3,9,9,3,12,3. Liga - Germany,3053403
Carl Zeiss Jena,1860 München,2020-03-07,0,3,3,n,0,2,2,0,2,0,1,1,0,1,3,1,4,4,7,7,4,11,3. Liga - Germany,3053404
MSV Duisburg,Magdeburg,2020-03-06,1,0,1,n,1,0,0,1,1,0,0,0,0,0,2,2,4,-1,-1,-1,-1,-1,3. Liga - Germany,3053405
Würzburger Kickers,Waldhof Mannheim,2020-03-07,0,0,0,n,0,0,0,0,0,0,0,0,0,0,2,3,5,5,6,6,5,11,3. Liga - Germany,3053407
Kaiserslautern,Meppen,2020-03-07,3,3,6,y,1,1,1,1,2,2,2,2,2,4,3,3,6,2,9,9,2,11,3. Liga - Germany,3053406
Uerdingen,Zwickau,2020-03-08,4,2,6,y,2,1,1,2,3,2,1,1,2,3,5,3,8,11,1,1,11,12,3. Liga - Germany,3053398
Hallescher FC,Ingolstadt,2020-03-08,1,1,2,y,0,0,0,0,0,1,1,1,1,2,2,5,7,-1,-1,-1,-1,-1,3. Liga - Germany,3053401
Viktoria Köln,Preußen Münster,2020-03-07,2,1,3,y,0,0,0,0,0,2,1,1,2,3,3,3,6,5,5,5,5,10,3. Liga - Germany,3053400
Hansa Rostock,Eintracht Braunschweig,2020-03-09,3,0,3,n,2,0,0,2,2,1,0,0,1,1,1,2,3,-1,-1,-1,-1,-1,3. Liga - Germany,3053399
Meppen,Würzburger Kickers,2020-05-30,1,3,4,y,0,0,0,0,0,1,3,3,1,4,2,2,4,8,5,5,8,13,3. Liga - Germany,3053410
Magdeburg,Kaiserslautern,2020-05-30,0,1,1,n,0,1,1,0,1,0,0,0,0,0,0,1,1,13,5,5,13,18,3. Liga - Germany,3053411
1860 München,MSV Duisburg,2020-05-31,3,2,5,y,0,1,1,0,1,3,1,1,3,4,2,1,3,5,5,5,5,10,3. Liga - Germany,3053412
Sonnenhof Großaspach,Unterhaching,2020-05-30,0,2,2,n,0,1,1,0,1,0,1,1,0,1,5,3,8,5,3,3,5,8,3. Liga - Germany,3053413
Ingolstadt,Bayern München II,2020-05-30,1,2,3,y,1,1,1,1,2,0,1,1,0,1,5,3,8,2,5,5,2,7,3. Liga - Germany,3053414
Preußen Münster,Hallescher FC,2020-05-31,4,2,6,y,3,0,0,3,3,1,2,2,1,3,1,3,4,-1,-1,-1,-1,-1,3. Liga - Germany,3053415
Eintracht Braunschweig,Viktoria Köln,2020-05-30,4,2,6,y,2,1,1,2,3,2,1,1,2,3,0,1,1,-1,-1,-1,-1,-1,3. Liga - Germany,3053416
Zwickau,Hansa Rostock,2020-05-30,2,2,4,y,0,2,2,0,2,2,0,0,2,2,2,2,4,-1,-1,-1,-1,-1,3. Liga - Germany,3053417
Waldhof Mannheim,Uerdingen,2020-05-30,1,2,3,y,0,1,1,0,1,1,1,1,1,2,1,2,3,-1,-1,-1,-1,-1,3. Liga - Germany,3053409
Carl Zeiss Jena,Chemnitzer FC,2020-05-31,0,1,1,n,0,0,0,0,0,0,1,1,0,1,3,2,5,-1,-1,-1,-1,-1,3. Liga - Germany,3053408
Viktoria Köln,Zwickau,2020-06-02,3,0,3,n,0,0,0,0,0,3,0,0,3,3,2,1,3,-1,-1,-1,-1,-1,3. Liga - Germany,3053418
Unterhaching,Ingolstadt,2020-06-02,1,2,3,y,1,1,1,1,2,0,1,1,0,1,2,1,3,5,4,4,5,9,3. Liga - Germany,3053421
Würzburger Kickers,Magdeburg,2020-06-02,0,1,1,n,0,1,1,0,1,0,0,0,0,0,8,4,12,-1,-1,-1,-1,-1,3. Liga - Germany,3053425
Uerdingen,Meppen,2020-06-02,0,0,0,n,0,0,0,0,0,0,0,0,0,0,2,2,4,2,5,5,2,7,3. Liga - Germany,3053426
Hansa Rostock,Waldhof Mannheim,2020-06-02,0,1,1,n,0,0,0,0,0,0,1,1,0,1,2,2,4,11,3,3,11,14,3. Liga - Germany,3053427
Hallescher FC,Eintracht Braunschweig,2020-06-03,0,1,1,n,0,1,1,0,1,0,0,0,0,0,5,2,7,-1,-1,-1,-1,-1,3. Liga - Germany,3053419
Bayern München II,Preußen Münster,2020-06-03,3,2,5,y,2,2,2,2,4,1,0,0,1,1,3,2,5,-1,-1,-1,-1,-1,3. Liga - Germany,3053420
Chemnitzer FC,Sonnenhof Großaspach,2020-06-03,0,1,1,n,0,0,0,0,0,0,1,1,0,1,4,4,8,-1,-1,-1,-1,-1,3. Liga - Germany,3053422
MSV Duisburg,Carl Zeiss Jena,2020-06-03,1,1,2,y,1,0,0,1,1,0,1,1,0,1,3,2,5,-1,-1,-1,-1,-1,3. Liga - Germany,3053423
Kaiserslautern,1860 München,2020-06-03,1,1,2,y,1,1,1,1,2,0,0,0,0,0,2,3,5,3,4,4,3,7,3. Liga - Germany,3053424
MSV Duisburg,Chemnitzer FC,2020-06-06,2,1,3,y,1,0,0,1,1,1,1,1,1,2,1,2,3,-1,-1,-1,-1,-1,3. Liga - Germany,3053428
Magdeburg,Uerdingen,2020-06-05,1,1,2,y,0,1,1,0,1,1,0,0,1,1,2,1,3,-1,-1,-1,-1,-1,3. Liga - Germany,3053429
1860 München,Würzburger Kickers,2020-06-06,1,2,3,y,0,1,1,0,1,1,1,1,1,2,4,0,4,7,3,3,7,10,3. Liga - Germany,3053430
Kaiserslautern,Carl Zeiss Jena,2020-06-07,2,1,3,y,2,0,0,2,2,0,1,1,0,1,2,5,7,3,8,8,3,11,3. Liga - Germany,3053431
Ingolstadt,Sonnenhof Großaspach,2020-06-07,1,1,2,y,1,1,1,1,2,0,0,0,0,0,4,4,8,-1,-1,-1,-1,-1,3. Liga - Germany,3053432
Preußen Münster,Unterhaching,2020-06-07,2,1,3,y,2,0,0,2,2,0,1,1,0,1,2,2,4,0,17,17,0,17,3. Liga - Germany,3053433
Eintracht Braunschweig,Bayern München II,2020-06-06,1,1,2,y,1,1,1,1,2,0,0,0,0,0,5,4,9,0,4,4,0,4,3. Liga - Germany,3053434
Zwickau,Hallescher FC,2020-06-06,5,1,6,y,1,0,0,1,1,4,1,1,4,5,5,4,9,3,7,7,3,10,3. Liga - Germany,3053435
Waldhof Mannheim,Viktoria Köln,2020-06-06,2,1,3,y,0,1,1,0,1,2,0,0,2,2,0,2,2,5,7,7,5,12,3. Liga - Germany,3053436
Meppen,Hansa Rostock,2020-06-06,0,3,3,n,0,2,2,0,2,0,1,1,0,1,3,4,7,-1,-1,-1,-1,-1,3. Liga - Germany,3053437
Bayern München II,Zwickau,2020-06-09,2,0,2,n,0,0,0,0,0,2,0,0,2,2,0,4,4,-1,-1,-1,-1,-1,3. Liga - Germany,3053438
Uerdingen,1860 München,2020-06-09,1,3,4,y,1,0,0,1,1,0,3,3,0,3,5,3,8,5,1,1,5,6,3. Liga - Germany,3053444
Hansa Rostock,Magdeburg,2020-06-09,3,1,4,y,1,0,0,1,1,2,1,1,2,3,3,2,5,-1,-1,-1,-1,-1,3. Liga - Germany,3053445
Viktoria Köln,Meppen,2020-06-09,1,3,4,y,1,2,2,1,3,0,1,1,0,1,1,3,4,-1,-1,-1,-1,-1,3. Liga - Germany,3053446
Hallescher FC,Waldhof Mannheim,2020-06-09,3,0,3,n,1,0,0,1,1,2,0,0,2,2,1,2,3,-1,-1,-1,-1,-1,3. Liga - Germany,3053447
Unterhaching,Eintracht Braunschweig,2020-06-10,1,3,4,y,1,3,3,1,4,0,0,0,0,0,4,1,5,16,2,2,16,18,3. Liga - Germany,3053439
Sonnenhof Großaspach,Preußen Münster,2020-06-10,0,0,0,n,0,0,0,0,0,0,0,0,0,0,3,1,4,4,2,2,4,6,3. Liga - Germany,3053440
Chemnitzer FC,Ingolstadt,2020-06-10,0,1,1,n,0,1,1,0,1,0,0,0,0,0,4,3,7,-1,-1,-1,-1,-1,3. Liga - Germany,3053441
Kaiserslautern,MSV Duisburg,2020-06-10,1,3,4,y,1,2,2,1,3,0,1,1,0,1,0,3,3,-1,-1,-1,-1,-1,3. Liga - Germany,3053442
Würzburger Kickers,Carl Zeiss Jena,2020-06-10,4,2,6,y,0,1,1,0,1,4,1,1,4,5,3,3,6,7,4,4,7,11,3. Liga - Germany,3053443
Kaiserslautern,Chemnitzer FC,2020-06-13,2,0,2,n,0,0,0,0,0,2,0,0,2,2,1,2,3,3,6,6,3,9,3. Liga - Germany,3053448
Carl Zeiss Jena,Uerdingen,2020-06-14,0,0,0,n,0,0,0,0,0,0,0,0,0,0,1,1,2,-1,-1,-1,-1,-1,3. Liga - Germany,3053449
MSV Duisburg,Würzburger Kickers,2020-06-13,1,1,2,y,0,1,1,0,1,1,0,0,1,1,1,2,3,7,5,5,7,12,3. Liga - Germany,3053450
Preußen Münster,Ingolstadt,2020-06-13,0,0,0,n,0,0,0,0,0,0,0,0,0,0,1,2,3,-1,-1,-1,-1,-1,3. Liga - Germany,3053451
Eintracht Braunschweig,Sonnenhof Großaspach,2020-06-13,2,1,3,y,1,0,0,1,1,1,1,1,1,2,1,0,1,-1,-1,-1,-1,-1,3. Liga - Germany,3053452
Zwickau,Unterhaching,2020-06-14,3,3,6,y,2,2,2,2,4,1,1,1,1,2,3,2,5,9,2,2,9,11,3. Liga - Germany,3053453
Waldhof Mannheim,Bayern München II,2020-06-14,2,3,5,y,1,3,3,1,4,1,0,0,1,1,2,3,5,-1,-1,-1,-1,-1,3. Liga - Germany,3053454
Meppen,Hallescher FC,2020-06-12,2,3,5,y,0,1,1,0,1,2,2,2,2,4,0,3,3,6,5,5,6,11,3. Liga - Germany,3053455
Magdeburg,Viktoria Köln,2020-06-13,2,0,2,n,1,0,0,1,1,1,0,0,1,1,4,2,6,-1,-1,-1,-1,-1,3. Liga - Germany,3053456
1860 München,Hansa Rostock,2020-06-13,0,1,1,n,0,0,0,0,0,0,1,1,0,1,1,1,2,4,4,4,4,8,3. Liga - Germany,3053457
Ingolstadt,Eintracht Braunschweig,2020-06-16,0,0,0,n,0,0,0,0,0,0,0,0,0,0,1,1,2,-1,-1,-1,-1,-1,3. Liga - Germany,3053459
Chemnitzer FC,Preußen Münster,2020-06-16,1,0,1,n,0,0,0,0,0,1,0,0,1,1,4,2,6,-1,-1,-1,-1,-1,3. Liga - Germany,3053460
Würzburger Kickers,Kaiserslautern,2020-06-16,2,0,2,n,0,0,0,0,0,2,0,0,2,2,2,1,3,12,2,2,12,14,3. Liga - Germany,3053461
Viktoria Köln,1860 München,2020-06-16,2,0,2,n,0,0,0,0,0,2,0,0,2,2,4,5,9,5,5,5,5,10,3. Liga - Germany,3053464
Hallescher FC,Magdeburg,2020-06-16,1,1,2,y,0,0,0,0,0,1,1,1,1,2,2,1,3,-1,-1,-1,-1,-1,3. Liga - Germany,3053465
Sonnenhof Großaspach,Zwickau,2020-06-17,1,0,1,n,0,0,0,0,0,1,0,0,1,1,4,5,9,3,2,2,3,5,3. Liga - Germany,3053458
Uerdingen,MSV Duisburg,2020-06-17,1,1,2,y,0,0,0,0,0,1,1,1,1,2,2,2,4,2,2,2,2,4,3. Liga - Germany,3053462
Hansa Rostock,Carl Zeiss Jena,2020-06-17,4,0,4,n,3,0,0,3,3,1,0,0,1,1,2,3,5,-1,-1,-1,-1,-1,3. Liga - Germany,3053463
Bayern München II,Meppen,2020-06-17,5,1,6,y,2,0,0,2,2,3,1,1,3,4,1,2,3,-1,-1,-1,-1,-1,3. Liga - Germany,3053466
Unterhaching,Waldhof Mannheim,2020-06-17,0,0,0,n,0,0,0,0,0,0,0,0,0,0,2,0,2,-1,-1,-1,-1,-1,3. Liga - Germany,3053467
Würzburger Kickers,Chemnitzer FC,2020-06-19,3,0,3,n,0,0,0,0,0,3,0,0,3,3,1,2,3,4,2,2,4,6,3. Liga - Germany,3053468
Kaiserslautern,Uerdingen,2020-06-20,4,0,4,n,2,0,0,2,2,2,0,0,2,2,1,1,2,-1,-1,-1,-1,-1,3. Liga - Germany,3053469
Eintracht Braunschweig,Preußen Münster,2020-06-20,1,0,1,n,1,0,0,1,1,0,0,0,0,0,2,4,6,-1,-1,-1,-1,-1,3. Liga - Germany,3053470
Zwickau,Ingolstadt,2020-06-21,0,3,3,n,0,2,2,0,2,0,1,1,0,1,3,2,5,-1,-1,-1,-1,-1,3. Liga - Germany,3053471
Waldhof Mannheim,Sonnenhof Großaspach,2020-06-20,3,2,5,y,2,0,0,2,2,1,2,2,1,3,5,1,6,6,7,7,6,13,3. Liga - Germany,3053472
Meppen,Unterhaching,2020-06-21,3,0,3,n,1,0,0,1,1,2,0,0,2,2,2,2,4,9,4,4,9,13,3. Liga - Germany,3053473
Magdeburg,Bayern München II,2020-06-20,2,2,4,y,2,0,0,2,2,0,2,2,0,2,5,2,7,-1,-1,-1,-1,-1,3. Liga - Germany,3053474
1860 München,Hallescher FC,2020-06-21,2,1,3,y,1,1,1,1,2,1,0,0,1,1,1,1,2,-1,-1,-1,-1,-1,3. Liga - Germany,3053475
Carl Zeiss Jena,Viktoria Köln,2020-06-20,2,3,5,y,1,1,1,1,2,1,2,2,1,3,3,2,5,-1,-1,-1,-1,-1,3. Liga - Germany,3053476
MSV Duisburg,Hansa Rostock,2020-06-20,0,0,0,n,0,0,0,0,0,0,0,0,0,0,0,3,3,2,2,2,2,4,3. Liga - Germany,3053477
Preußen Münster,Zwickau,2020-06-24,2,1,3,y,0,0,0,0,0,2,1,1,2,3,2,4,6,-1,-1,-1,-1,-1,3. Liga - Germany,3053478
Chemnitzer FC,Eintracht Braunschweig,2020-06-23,1,2,3,y,0,2,2,0,2,1,0,0,1,1,3,4,7,-1,-1,-1,-1,-1,3. Liga - Germany,3053479
Uerdingen,Würzburger Kickers,2020-06-23,1,2,3,y,1,1,1,1,2,0,1,1,0,1,6,1,7,1,8,8,1,9,3. Liga - Germany,3053480
Hansa Rostock,Kaiserslautern,2020-06-23,1,1,2,y,0,1,1,0,1,1,0,0,1,1,0,1,1,-1,-1,-1,-1,-1,3. Liga - Germany,3053481
Viktoria Köln,MSV Duisburg,2020-06-23,1,0,1,n,0,0,0,0,0,1,0,0,1,1,2,2,4,-1,-1,-1,-1,-1,3. Liga - Germany,3053482
Hallescher FC,Carl Zeiss Jena,2020-06-24,5,3,8,y,2,2,2,2,4,3,1,1,3,4,1,2,3,-1,-1,-1,-1,-1,3. Liga - Germany,3053483
Bayern München II,1860 München,2020-06-24,2,1,3,y,1,1,1,1,2,1,0,0,1,1,1,2,3,-1,-1,-1,-1,-1,3. Liga - Germany,3053484
Unterhaching,Magdeburg,2020-06-24,0,0,0,n,0,0,0,0,0,0,0,0,0,0,2,4,6,-1,-1,-1,-1,-1,3. Liga - Germany,3053485
Sonnenhof Großaspach,Meppen,2020-06-24,1,2,3,y,1,0,0,1,1,0,2,2,0,2,3,1,4,4,4,4,4,8,3. Liga - Germany,3053486
Ingolstadt,Waldhof Mannheim,2020-06-24,2,0,2,n,1,0,0,1,1,1,0,0,1,1,4,4,8,-1,-1,-1,-1,-1,3. Liga - Germany,3053487
Uerdingen,Chemnitzer FC,2020-06-26,1,1,2,y,1,0,0,1,1,0,1,1,0,1,2,5,7,5,6,6,5,11,3. Liga - Germany,3053488
Zwickau,Eintracht Braunschweig,2020-06-27,3,2,5,y,0,1,1,0,1,3,1,1,3,4,4,0,4,2,5,5,2,7,3. Liga - Germany,3053489
Waldhof Mannheim,Preußen Münster,2020-06-27,0,0,0,n,0,0,0,0,0,0,0,0,0,0,0,1,1,-1,-1,-1,-1,-1,3. Liga - Germany,3053490
Meppen,Ingolstadt,2020-06-28,0,2,2,n,0,1,1,0,1,0,1,1,0,1,0,2,2,-1,-1,-1,-1,-1,3. Liga - Germany,3053491
Magdeburg,Sonnenhof Großaspach,2020-06-28,0,1,1,n,0,0,0,0,0,0,1,1,0,1,2,1,3,9,1,1,9,10,3. Liga - Germany,3053492
1860 München,Unterhaching,2020-06-27,3,0,3,n,1,0,0,1,1,2,0,0,2,2,2,3,5,-1,-1,-1,-1,-1,3. Liga - Germany,3053493
Carl Zeiss Jena,Bayern München II,2020-06-27,1,2,3,y,1,1,1,1,2,0,1,1,0,1,2,3,5,-1,-1,-1,-1,-1,3. Liga - Germany,3053494
MSV Duisburg,Hallescher FC,2020-06-27,2,2,4,y,1,2,2,1,3,1,0,0,1,1,2,4,6,6,5,5,6,11,3. Liga - Germany,3053495
Kaiserslautern,Viktoria Köln,2020-06-27,3,0,3,n,1,0,0,1,1,2,0,0,2,2,0,2,2,2,2,2,2,4,3. Liga - Germany,3053496
Würzburger Kickers,Hansa Rostock,2020-06-27,3,1,4,y,2,0,0,2,2,1,1,1,1,2,0,2,2,9,3,3,9,12,3. Liga - Germany,3053497
Zwickau,Chemnitzer FC,2020-07-01,2,1,3,y,0,0,0,0,0,2,1,1,2,3,1,3,4,-1,-1,-1,-1,-1,3. Liga - Germany,3053498
Hansa Rostock,Uerdingen,2020-07-01,1,0,1,n,1,0,0,1,1,0,0,0,0,0,1,2,3,-1,-1,-1,-1,-1,3. Liga - Germany,3053499
Viktoria Köln,Würzburger Kickers,2020-07-01,5,1,6,y,0,0,0,0,0,5,1,1,5,6,0,0,0,-1,-1,-1,-1,-1,3. Liga - Germany,3053500
Hallescher FC,Kaiserslautern,2020-07-01,1,1,2,y,1,0,0,1,1,0,1,1,0,1,3,3,6,-1,-1,-1,-1,-1,3. Liga - Germany,3053501
Bayern München II,MSV Duisburg,2020-07-01,2,2,4,y,0,1,1,0,1,2,1,1,2,3,1,3,4,-1,-1,-1,-1,-1,3. Liga - Germany,3053502
Unterhaching,Carl Zeiss Jena,2020-07-01,2,2,4,y,0,0,0,0,0,2,2,2,2,4,1,5,6,-1,-1,-1,-1,-1,3. Liga - Germany,3053503
Sonnenhof Großaspach,1860 München,2020-07-01,2,4,6,y,2,2,2,2,4,0,2,2,0,2,2,1,3,2,6,6,2,8,3. Liga - Germany,3053504
Ingolstadt,Magdeburg,2020-07-01,0,2,2,n,0,0,0,0,0,0,2,2,0,2,2,5,7,-1,-1,-1,-1,-1,3. Liga - Germany,3053505
Preußen Münster,Meppen,2020-07-01,0,3,3,n,0,1,1,0,1,0,2,2,0,2,3,0,3,-1,-1,-1,-1,-1,3. Liga - Germany,3053506
Eintracht Braunschweig,Waldhof Mannheim,2020-07-01,3,2,5,y,2,1,1,2,3,1,1,1,1,2,2,1,3,-1,-1,-1,-1,-1,3. Liga - Germany,3053507
Carl Zeiss Jena,Sonnenhof Großaspach,2020-07-04,1,0,1,n,0,0,0,0,0,1,0,0,1,1,1,0,1,-1,-1,-1,-1,-1,3. Liga - Germany,3053512
Uerdingen,Viktoria Köln,2020-07-04,1,1,2,y,1,0,0,1,1,0,1,1,0,1,2,2,4,4,6,6,4,10,3. Liga - Germany,3053516
Chemnitzer FC,Hansa Rostock,2020-07-04,4,2,6,y,0,0,0,0,0,4,2,2,4,6,3,1,4,-1,-1,-1,-1,-1,3. Liga - Germany,3053517
Waldhof Mannheim,Zwickau,2020-07-04,0,0,0,n,0,0,0,0,0,0,0,0,0,0,1,2,3,4,4,4,4,8,3. Liga - Germany,3053508
Meppen,Eintracht Braunschweig,2020-07-04,4,3,7,y,3,1,1,3,4,1,2,2,1,3,2,1,3,4,5,5,4,9,3. Liga - Germany,3053509
Magdeburg,Preußen Münster,2020-07-04,2,2,4,y,0,0,0,0,0,2,2,2,2,4,0,2,2,-1,-1,-1,-1,-1,3. Liga - Germany,3053510
1860 München,Ingolstadt,2020-07-04,0,2,2,n,0,0,0,0,0,0,2,2,0,2,8,1,9,-1,-1,-1,-1,-1,3. Liga - Germany,3053511
MSV Duisburg,Unterhaching,2020-07-04,4,0,4,n,1,0,0,1,1,3,0,0,3,3,2,2,4,5,2,2,5,7,3. Liga - Germany,3053513
Kaiserslautern,Bayern München II,2020-07-04,1,0,1,n,0,0,0,0,0,1,0,0,1,1,2,2,4,-1,-1,-1,-1,-1,3. Liga - Germany,3053514
Würzburger Kickers,Hallescher FC,2020-07-04,2,2,4,y,1,1,1,1,2,1,1,1,1,2,3,2,5,7,4,4,7,11,3. Liga - Germany,3053515
